1111111111111111111111111111111111111
1P00000000000001001000000000000001111
1000000100100001001001000000010101111
10000100101010010010010000000101C1111
100000000000C0000C0000000E00000001111
1111111111111111111111111111111111111